18th Century	18th century
abnormal psychology	abnormal psychology
acculturation	acculturation
active learning	active learning
African American history	African American history
African history	African history
aging	aging
American studies	American studies
animal behavior	animal behavior
assessment	assessment
behavioral ecology	behavioral ecology
bilingualism	bilingualism
Biochemistry	biochemistry
biodiversity	biodiversity
biogeography	biogeography
bioinformatics	bioinformatics
Biological Sciences	biological sciences
biology	biology
Botany	botany
British history	British history
C. elegans	C. elegans
cell biology	cell biology
Child development	child development
church history	church history
civil rights movement	civil rights movement
clinical psychology	clinical psychology
cognition	cognition
cognitive development	cognitive development
cognitive neuroscience	cognitive neuroscience
cognitive psychology	cognitive psychology
collective memory	collective memory
colonialism	colonialism
community psychology	community psychology
consciousness	consciousness
conservation biology	conservation biology
cultural history	cultural history
Developmental Biology	developmental biology
developmental psychology	developmental psychology
digital humanities	digital humanities
ecology	ecology
electrophysiology	electrophysiology
emotion	emotion
emotion regulation	emotion regulation
Environmental history	environmental history
environmental science	environmental science
European history	European history
Evolution	evolution
evolutionary biology	evolutionary biology
Experimental Psychology	experimental psychology
feminism	feminism
French history	French history
gardens	gardens
gender	gender
genetics	genetics
genomics	genomics
gerontology	gerontology
health psychology	health psychology
historical memory	historical memory
history	history
history of psychology	history of psychology
human physiology	human physiology
identity	identity
Immunology	immunology
infancy	infancy
infectious diseases	infectious diseases
intellectual history	intellectual history
international relations	international relations
introductory biology	introductory biology
invasive species	invasive species
Irish history	Irish history
language	language
Latin America	Latin America
learning	learning
linguistics	linguistics
medieval history	medieval history
memory	memory
metacognition	metacognition
microbiology.	microbiology
Modern European History	modern European history
modernism	modernism
molecular biology	molecular biology
Molecular evolution	molecular evolution
music	music
neuroscience	neuroscience
Parasitology	parasitology
personality	personality
Physiology	physiology
plant biology	plant biology
plant ecology	plant ecology
popular religion	popular religion
population genetics	population genetics
Positive Psychology	positive psychology
psychology	psychology
psychopathology	psychopathology
psychophysiology	psychophysiology
Race	race
Research methods	research methods
sexuality	sexuality
slavery	slavery
social change	social change
social psychology	social psychology
South Asia	South Asia
statistics	statistics
stereotyping	stereotyping
sustainability	sustainability
U.S. History	U.S. History
urban history	urban history
women	women
World history	world history
writing	writing
Arafat	Arafat
CD	CD
FBI	FBI
Jackson	Jackson
afternoon	afternoon
animal	animal
architecture	architecture
article	article
artifact	artifact
bird	bird
calculation	calculation
car	car
challenge	challenge
clinic	clinic
coast	coast
communication	communication
computation	computation
concert	concert
consumer	consumer
crane	crane
culture	culture
cup	cup
currency	currency
death	death
delay	delay
depression	depression
doctor	doctor
dollar	dollar
drink	drink
earning	earning
effort	effort
energy	energy
equality	equality
equipment	equipment
female	female
film	film
five	five
food	food
game	game
gender	gender
hardware	hardware
hospital	hospital
hypertension	hypertension
image	image
infrastructure	infrastructure
investigation	investigation
investor	investor
law	law
lawyer	lawyer
life	life
love	love
maker	maker
ministry	ministry
minority	minority
money	money
month	month
movie	movie
museum	museum
music	music
network	network
number	number
object	object
observation	observation
peace	peace
personnel	personnel
physics	physics
plane	plane
planet	planet
problem	problem
project	project
prominence	prominence
property	property
proton	proton
psychology	psychology
racism	racism
reason	reason
record	record
recovery	recovery
round	round
row	row
sex	sex
shirt	shirt
shore	shore
size	size
star	star
stock	stock
substance	substance
surface	surface
telephone	telephone
theater	theater
tiger	tiger
train	train
treatment	treatment
virtuoso	virtuoso
woman	woman
yen	yen
